00000000000000000000000000000000
01111111111111111111111111111110
01111111111111111111111111111110
01111111111111111111133321111110
01111111111111111111111131111110
01111111111111111111111131111110
01111111111111111111811131111110
01111111111111111111111111111110
01111111111111113111111111111110
01111111111111132311111111111110
01111111111111113111111111111110
01111111111111111111111111111110
01111111111111111111111111111110
01111111111111111111111111111110
01111131111111111111111111111110
01111131111111111111111111111110
01111131111111111111111111111110
01141123331111111111111111111110
01111111111111111111111111111110
00000000000000000000000000000000
