00000000000000000000000000000000
01111111111111111111111111111110
01111111111111111111111111111110
01111112222222222222111111111110
01111111111111111112111111111110
01111111111111111112111111111110
01111111111118111112222211111110
01111111111111111111111111111110
01111111111111111111111111111110
01111111111111111111111111111110
01111111111222222222233331111110
01111111111111111111111111111110
01111111111111111111111111111110
01111111111111111111111111111110
01111122222222222222222222111110
01111111111111111111111111111110
01111111111111111111111111111110
01111111111111111411111111111110
01111111111111111111111111111110
00000000000000000000000000000000