00000000000000000000000000000000
01111111111111111111111111111110
01111111111111111111111111111110
01111122222222222222222222111110
01111111111111111111111111111110
01111111111111111111111111111110
01111111111111111111111111111110
01111111111111111111111111111110
01111111111111111111111111111110
01111111111111811111111111111110
01111111111111111111111111111110
01111111111111111111111111111110
01111111111111111111111111111110
01111111111111111111111111111110
01111111111111111111111111111110
01111111111111111111111111111110
01111122222222222222222222111110
01111111111111111111111111111110
01111111111111411111111111111110
00000000000000000000000000000000