00000000000000000000000000000000
01111111111111111111111111111110
01111111111111181111111111111110
01111111111111111111111111111110
01111111111111111111111111111110
03333333333333333333333333333330
01111111111111111111111111111110
01111111111111111111111111111110
01111111111111111111111111111110
01111111111111111111111111111110
03333333333222222222233333333330
01111111111111111111111111111110
01111111111111111111111111111110
01111111111111111111111111111110
01111111111111111111111111111110
03333333333333333333333333333330
01111111111111111111111111111110
01111411111111111111111111111110
01111111111111111111111111111110
00000000000000000000000000000000