00000000000000000000000000000000
01111111111111111111111111111110
01111111111111141111111111111110
01111111111111111111111111111110
01111222222223333322222222211110
01111111111111131111111111111110
01111111111111131111111111111110
01111111111111131111111111111110
01111111111111121111111111111110
01111111111111121111111111111110
01111111111111121111111111111110
01111111111111121111111111111110
01111111111111121111111111111110
01111111811111121111111111111110
01111111111111121111111111111110
01111111111111111111111111111110
01111111111111111111111111111110
01111111111111111111111111111110
01111111111111111111111111111110
00000000000000000000000000000000