00000000000000000000000000000000
01111111111111111111111111111110
01111121111111111111111112111110
01111121111111111111111112111110
01111121111111111111111112111110
01111121111111111111111112111110
01111121111111111111111112111110
01111131111111181111111113111110
01111131111111111111111113111110
01111131111111111111111113111110
01111122223333333333332222111110
01111131111111111111111113111110
01111131111111111111111113111110
01111131111111111111111113111110
01111121111111111111111112111110
01111121111111141111111112111110
01111121111111111111111112111110
01111121111111111111111112111110
01111111111111111111111111111110
00000000000000000000000000000000