00000000000000000000000000000000
01111111111111111111111111111110
01111111111111111111111111111110
01111111111111111111111111111110
01111111122222222222222111111110
01111111111111111111111111111110
01111111111111111111111111111110
01111111111111118111111111111110
01111111111111111111111111111110
02222222222222211111222222222220
01111111111111111111111111111110
01111111111111111111111111111110
01111111111111111111111111111110
01111111111111111111111111111110
01111133333333333333333333111110
01111111111111111111111111111110
01111111111111111111111111111110
01111111111111111111111111111110
01111111111111141111111111111110
00000000000000000000000000000000