00000000000000000000000000000000
01111111111111111111111111111110
01111111811111111111111111111110
02222333322222333322223333111110
01111111111111111111111111111110
01111111111111111111111111111110
01111122223333222233333222233320
01111111111111111111111111111110
01111111111111111111111111111110
02222333322223333222233331111110
01111111111111111111111111111110
01111111111111111111111111111110
01111122223333222233332222333320
01111111111111111111111111111110
01111111111111111111111111111110
02222333322223333222233332111110
01111111111111111111111111111110
01111411111111111111111111111110
01111111111111111111111111111110
00000000000000000000000000000000