00000000000000000000000000000000
01111111111111111111111111111110
01111111111111111111111111111110
01111111111111111111111111111110
01111133322222222222222333111110
01111131111111111111111113111110
01111131111111111111111113111110
01111131111111111111111113111110
01111121111111111111111112111110
01111121111111118111111112111110
01111121111111111111111112111110
01111121111111111111111112111110
01111131111111111111111113111110
01111131111111111111111113111110
01111131111111111111111113111110
01111133322222222222223333111110
01111111111111111111111111111110
01111111111111141111111111111110
01111111111111111111111111111110
00000000000000000000000000000000